..............................
....++++++.....................
..............................
..............................
.....................>>.......
............1.................
...>>......-----..............
........................1.....
.....................++++++...
..............................
.........------...............
..............................
.....P...1..........1.........
....-------.....------........